######################
#      ........      #
######## ######## ####
#   .     .#         #
##### ###### ### ## ##
#     .              #
######################